{
  "40": 1,
  "41": 2,
  "42": 0,
  "43": 1,
  "44": 0,
  "45": 2,
  "46": 2,
  "47": 1,
  "48": 1,
  "49": 2
}